# 0:未定義, 1:海, 2:海岸右, 3:海岸左, 4:海岸下, 5,海岸上, 6:海岸／, 7:海岸＼, 8:草原, 9:林, 10:低山, 11:高山, 12:砦, 13:家, 14:店, 15:村, 16:城
# ユニット配置原点: 25, 5
1, 1, 1, 1, 1, 1, 1, 1, 1, 1, 1, 1, 1, 1, 1, 1, 1, 1, 1, 1, 1, 1, 1, 1, 1, 1, 1, 1, 1, 1, 1, 1,
1, 1, 1, 1, 1, 4, 4, 4, 1, 1, 1, 1, 1, 1, 1, 1, 1, 1, 1, 1, 1, 1, 1, 1, 1, 1, 4, 1, 1, 1, 1, 1,
1, 1, 1, 1, 6, 8, 8, 8, 7, 1, 1, 1, 1, 1, 1, 1, 1, 1, 1, 1, 4, 4, 4, 4, 4, 6, 8, 7, 4, 1, 1, 1,
1, 1, 1, 6, 8, 8, 8, 8,11, 7, 1, 1, 1, 1, 1, 1, 4, 4, 4, 6,13,13,13, 8, 8, 8,14, 8, 8, 7, 1, 1,
1, 1, 6, 8, 8, 8, 8, 8,11,11, 7, 1, 1, 1, 1, 6,12, 8, 8, 8, 8, 8, 8, 8, 8, 8, 8, 8, 8, 8, 2, 1,
1, 2, 8, 8, 8,16, 8, 8,11,11,11, 7, 4, 4, 6, 8, 8, 8, 8, 8, 9, 8, 8, 8, 8, 8, 8,15, 8, 8, 2, 1,
1, 2, 8, 8, 8, 8, 8, 9,11,11,11,11,11,11, 8, 8, 8, 8, 8, 8, 8, 6, 5, 7, 8, 8, 8, 8, 8, 8, 2, 1,
1, 2, 8, 8, 8, 8, 8, 8, 9,11,11,11, 9, 8, 8, 8, 9, 8, 8, 8, 6, 1, 4, 6, 8,12, 8, 8, 8, 8, 2, 1,
1, 2, 8, 8, 8, 8, 8, 8, 8,10,10, 9, 8, 8, 8, 8, 8, 8, 6, 5, 1, 6, 8, 8, 8, 8, 8, 8, 8, 6, 1, 1,
1, 2, 8, 8,15, 8, 8, 8,10, 8, 8, 8, 8, 8, 8, 8, 9, 9, 3, 1, 6, 8, 8, 8, 8, 8, 8, 8, 6, 1, 1, 1,
1, 1, 7, 8, 8, 8, 8, 8, 8,12, 8, 8, 8, 8, 8, 9, 9, 6, 1, 2, 9, 8,15, 8, 8, 9, 8, 6, 1, 1, 1, 1,
1, 1, 1, 7, 8, 8, 8, 8, 8, 8, 8, 8, 9, 8, 8, 6, 5, 1, 1, 1, 7, 8, 8, 9, 8, 8, 8, 2, 1, 1, 1, 1,
1, 1, 1, 1, 7, 8,13,13, 6, 5, 5, 7, 8, 8, 6, 1, 1, 1, 1, 1, 1, 5, 5, 5, 7, 9, 9, 2, 1, 1, 1, 1,
1, 1, 1, 1, 1, 5, 5, 5, 1, 1, 1, 1, 5, 5, 1, 1, 1, 1, 1, 1, 1, 1, 1, 1, 1, 5, 5, 1, 1, 1, 1, 1,
1, 1, 1, 1, 1, 1, 1, 1, 1, 1, 1, 1, 1, 1, 1, 1, 1, 1, 1, 1, 1, 1, 1, 1, 1, 1, 1, 1, 1, 1, 1, 1,
